7 7
###############
#@#@#.......#2#
#.#.#####.###.#
#.#.#.#.#.#...#
#.#.#.#.#.#.###
#@.......@.@#.#
#######.#.#.#.#
#.......#.#...#
#.#.#.#.#.#####
#.#.#@#.#....@#
#####.#.###.#.#
#.....#...#.#.#
#.###.###.#.###
#1#.#@#@..#@.@#
###############
