11 11
#######################
#.........#..........2#
#.#######.#.#.#########
#.#@.@.@#.#.#........@#
#.#####.#.#.#.#####.#.#
#......@#.#.#.#@#...#.#
#########.#.#.#.#.###.#
#.......#.#.#.#.#@#@..#
#.#.#.#.#.#.#.#.#######
#.#@#@#@#.#.#......@.@#
#.#######.#.###########
#@.........@.........@#
###########.#.#######.#
#@.@......#.#.#@#@#@#.#
#######.#.#.#.#.#.#.#.#
#..@#@#.#.#.#.#.......#
#.###.#.#.#.#.#########
#.#...#@#.#.#.#@......#
#.#.#####.#.#.#.#####.#
#@........#.#.#@.@.@#.#
#########.#.#.#######.#
#1..........#.........#
#######################
